╔════════════════════════════════════════════════════════════════════════════════════════════════════════════════════════════════════════════════════╗
║░░░╔══════════════════╗░░░░░░░░░░░░░░░░░░░░░░░░░░░░░░░░░░░╔═════════════════════════════════════╗░░░░░░░░░░░░░░░░░░░░░░░░░░░░░░░░░░░░░░░░░░░░░░░░░░░║
║░░░║                  ║░░░░░░░░░░░░░░░░░░░░░░░░░░░░░░░░░░░║                                     ║░░░░░░░░░░░░░░░░░░░░░░░░░░░░╔══════════╗░░░░░░░░░░░║
║░░░║                  ║░░░░░░░░░░░░░░░░░░░░░░░░░░░░░░░░░░░║                                     ║░░░░░░░░░░░░░░░░░░░░░░░░░░░░║          ║░░░░░░░░░░░║
║░░░║                  ╚════════════════════════╗░░░░░░░░░░╚══════════════════════╗ ╔════════════╝░░░░░░░░░░░░░░░░░░░░░░░░░░░░║          ║░░░░░░░░░░░║
║░░░║                                           ║░░░░░░░░░░░░░░░░░░░░░░░░░░░░░░░░░║ ║░░░░░░░░░░░░░░░░░░░░░░░░░░░░░░░░░░░░░░░░░║          ║░░░░░░░░░░░║
║░░░║                  ╔══════════════════════╗ ║░░░░░░░░░░░░░░░░░░░░░░░░░░░░░░░░░║ ║░░░░░░░░░░╔══════════════════════════════╝          ║░░░░░░░░░░░║
║░░░║                  ║░░░░░░░░░░░░░░░░░░░░░░║ ╚════════════════════╗░░░░░░░░░░░░║ ║░░░░░░░░░░║                                         ║░░░░░░░░░░░║
║░░░║                  ║░░░░░░░░░░░░░░░░░░░░░░║                      ╚════════════╝ ║░░░░░░░░░░║                                         ║░░░░░░░░░░░║
║░░░╚══════════════════╝░░░░░░░░░░░░░░░░░░░░░░║ ╔══════════════════╗                ║░░░░░░░░░░║                                         ║░░░░░░░░░░░║
║░░░░░░░░░░░░░░░░░░░░░░░░░░░░░░░░░░░░░░░░░░░░░║ ║░░░░░░░░░░░░░░░░░░║ ╔══════════════╝░░░░░░░░░░║                                         ║░░░░░░░░░░░║
║░░░░░░░░░░░░░░░░░░░░░░░░░░░░░░░░░░╔══════════╝ ║░░░░░░░░░░░░░░░░░░║ ╚═══════╗░░░░░░░░░░░░░░░░░╚══════════╗ ╔════════════════════════════╝░░░░░░░░░░░║
║░░░░░░░░░░╔═══════════════════════╝            ║░░░░░░░░░░░░░░░░░░║         ║░░░░░░░░░░░░░░░░░░░░░░░░░░░░║ ║░░░░░░░░░░░░░░░░░░░░░░░░░░░░░░░░░░░░░░░░║
║░░░░░░░░░░║                         ╔════════╗ ║░░░░░░░░░╔════╗░░░╚═══════╗ ║░░░░░░░░░░░░░░░░░░░░░░░░░░░░║ ║░░░░░░░░░░░░░░░░░░░░░░░░░░░░░░░░░░░░░░░░║
║░░░░░░░░░░║                ╔════════╝░░░░░░░░║ ║░░░░░░░░░║    ║░░░░░░░░░░░║ ║░░░░░░░░░░░░░░░░░░░░░░░░░░░░║ ║░░░░░░░░░░░░░░░░░░░░░░░░░░░░░░░░░░░░░░░░║
║░░░░░░░░░░║                ║░░░░░░░░░░░░░░░░░║ ║░░░░░░░░░║    ║░░░░░░░░░░░║ ║░░░░░░░░░░░░░░░░░░░░░░░░░░░░║ ║░░░░░░░░░░░░░░░░░░░░░░░░░░░░░░░░░░░░░░░░║
║░░░░░░░░░░║                ║░░░░░░░░░░░░░░░░░║ ║░░░░░░░░░║    ╚╗░░░░░░░░░░║ ╚═════════════════════╗░░░░░░║ ║░░░░░╔══════════════════════════╗░░░░░░░║
║░░░░░░░░░░║                ║░░░░░░░░░░░░░░░░░║ ║░░░░░░░░░╚══╗  ║░░░░░░░░░░║                       ║░░░░░░║ ║░░░░░║                          ║░░░░░░░║
║░░░░░╔════╩══════╗         ║░░░░░░░░░░░░░░░░░║ ║░░░░░░░░░░░░║  ║░░░░░░░░░░║                       ╚══════╝ ║░░░░░║                          ║░░░░░░░║
║░░░░░║           ║         ║░░░░░░░░╔════════╝ ╚═══════╗░░░░║  ║░░░░░░░░░░╚══════════╗                     ║░░░░░║                          ║░░░░░░░║
║░░░░░║           ║         ║░░░░░░░░║                  ║░░░░║  ║░░░░░░░░░░░░░░░░░░░░░║            ╔════════╝░░░░░║                          ║░░░░░░░║
║░░░░░║       ════╬═════    ║░░░░░░░░║                  ║░░░░║  ║░░░░░░░░░░░░░░░░░░░░░║            ║░░░░░░░░░░░░░░║                          ║░░░░░░░║
║░░░░░║           ║         ║░░░░░░░░║                  ╚════╝  ╚══════╗░░░░░░░░░░░░░░║            ║░░░░░░░░░░░░░░║ ╔═════════════╗  ╔═══════╝░░░░░░░║
║░░░░░║           ║         ║░░░░░░░░║                                 ║░░░░░░░░░░░░░░║            ║░░░░░░░░░░░░░░║ ║░░░░░░░░░░░░░║  ║░░░░░░░░░░░░░░░║
║░░░░░║                     ║░░░░░░░░║                  ╔════════════╗ ║░░░░░░░░░░░░░░║            ║░░░░░░░░░░░░░░║ ║░░░░░░░░░░░░░║  ║░░░░░░░░░░░░░░░║
║░░░░░║                     ║░░░░░░░░║                  ║░░░░░░░░░░░░║ ║░░░░░░░░░░░░░░║            ╚══════════════╝ ║░░░░░░░░░░░░░║  ║░░░░░░░░░░░░░░░║
║░░░░░║                     ║░░░░░░░░║                  ║░░░░░░░░░░░░║ ║░░░░░░░░░░░░░░║                             ║░░░░░░░░░░░░░║  ║░░░░░░░░░░░░░░░║
║░░░░░╚══════╗ ╔════════════╝░░░░░░░░╚══════════════════╝░░░░░░░░░░░░║ ╚══════════════╝            ╔════════════════╝░░░░░░╔══════╝  ╚════════╗░░░░░░║
║░░░░░░░░░░░░║ ║░░░░░░░░░░░░░░░░░░░░░░░░░░░░░░░░░░░░░░░░░░░░░░░░░░░░░║                             ║░░░░░░░░░░░░░░░░░░░░░░░║                  ║░░░░░░║
║░░░░░░░░░░░░║ ║░░░░░░░░░░░░░░░░░░░░░░░░░░░░░░░░░░░░░░░░░░░░░░░░░░░░░║                             ║░░░░░░░░░░░░░░░░░░░░░░░║                  ║░░░░░░║
║░░░░░░░░░░░░║ ╚═══════════╗░░░░╔═══════════════╗░░░░░░░░░░░░░░░░░░░░║                             ║░░░░░░░░░░░░░░░░░░░░░░░║                  ║░░░░░░║
║░░░░░░░░░░░░║             ╚╗░░╔╝               ║░░░░░░░░░░░░░░░░░░░░╚═════════════════════════════╝░░░░░░░░░░░░░░░░░░░░░░░║                  ║░░░░░░║
║░░░░░░░░░░░░║              ╚══╝                ║░░░░░░░░░░░░░░░░░░░░░░░░░░░░░░░░░░░░░░░░░░░░░░░░░░░░░░░░░░░░░░░░░░░░░░░░░░║                  ║░░░░░░║
║░░░░░░░░░░░░║                                  ║░░░░░░░░░░░░░░░░░░░░░░░░░░░░░░░░░░░░░░░░░░░░░░░░░░░░░░░░░░░░░░░░░░░░░░░░░░║                  ║░░░░░░║
║░░░░░░░░░░░░║                                  ║░░░░░░░░░░░░░░░░░░░░░░░░░░░░░░░░░░░░░░░░░░░░░░░░░░░░░░░░░░░░░░░░░░░░░░░░░░╚══════════════════╝░░░░░░║
║░░░░░░░░░░░░╚══════════════════════════════════╝░░░░░░░░░░░░░░░░░░░░░░░░░░░░░░░░░░░░░░░░░░░░░░░░░░░░░░░░░░░░░░░░░░░░░░░░░░░░░░░░░░░░░░░░░░░░░░░░░░░░║
║░░░░░░░░░░░░░░░░░░░░░░░░░░░░░░░░░░░░░░░░░░░░░░░░░░░░░░░░░░░░░░░░░░░░░░░░░░░░░░░░░░░░░░░░░░░░░░░░░░░░░░░░░░░░░░░░░░░░░░░░░░░░░░░░░░░░░░░░░░░░░░░░░░░░║
╚════════════════════════════════════════════════════════════════════════════════════════════════════════════════════════════════════════════════════╝