╔════════════════════════════════════════════════════════════════════════════════════════════════════════════════════════════════════════════════════╗
║░░░░░░░░░░░░░░░░░░░░░░░░░░░░░░░░░░░░░░░░░░░░░░░░░░░░░░░░░░░░░░░░░░░░░░╔═══════════════════╗░░░░░░░░╔══════════════════╗░░░░░░░░░░░░░░░░░░░░░░░░░░░░░║
║░░░╔═════════════════════╗░░░░░░░░░░░░░░░░░░░░░╔════════════╗░░░░░░░░░║                   ║░░░░░░░░║                  ║░░░░░░░░░░░░░░░░░░░░░░░░░░░░░║
║░░░║                     ║░░░░░░░░░░░░░░░░░░░░░║            ║░░░░░░░░░║                   ║░░░░░░░░║                  ║░░░░░░░░░░╔══════════════╗░░░║
║░░░║                     ╚═════════════════════╝            ║░░░░░░░░░║                   ║░░░░░░░░║                  ║░░░░░░░░░░║              ║░░░║
║░░░║                                                        ║░░░░░░░░░║                   ║░░░░░░░░║  ╔═════════╗     ║░░░░░░░░░░║              ║░░░║
║░░░║                     ╔══════════════╗                   ║░░░░░░░░░║                  ╔╝░░░░░░░░║  ║░░░░░░░░░║     ╚═══╗░░░░░░║              ║░░░║
║░░░║                     ║░░░░░░░░░░░░░░║                   ║░░░░░░░░░╚══════╗           ║░░░░░░░░░║  ║░░░░░░░░░║         ║░░░░░░║              ║░░░║
║░░░╚═══════════╗ ╔═══════╝░░░░░░░░░░░░░░║                   ║░░░░░░░░░░░░░░░░║       ╔═══╝░░░░░░░░░║  ║░░░░░░░░░║         ║░░░░░░║              ║░░░║
║░░░░░░░░░░░░░░░║ ║░░░░░░░░░░░░░░░░░░░░░░║                   ╚══════╗░░░░░░░░░║       ║░░░░░░░░░░░░░║  ╚═════╗░░░╚═════════╝░░░░░░║         ╔════╝░░░║
║░░░░░░░░░░░░░░░║ ║░░░░╔═════════╗░░░░░░░║                          ║░░░░░░░░░║       ║░░░░░░░░░░░░░║        ║░░░░░░░░░░░░░░░░░░░░║         ║░░░░░░░░║
║░░░░░░░░░░░░░░░║ ║░░░░║         ║░░░░░░░║                          ║░░░░░░░░░║  ╔════╝░░░░░░░░░░░░░║        ║░░░░░░░░░░░░░░░░░░░░║         ║░░░░░░░░║
║░░░░░░░░░░░░░░░║ ║░░░░║         ║░░░░░░░║                  ╔═══════╝░░░░░░░░░║  ║░░░░░░░░░░░░░░░╔══╝        ╚════════════════════╝         ║░░░░░░░░║
║░░░░░░╔════════╝ ╚════╝         ║░░░░░░░║                 ╔╝░░░░░░░░░░░░░░░░░║  ║░░░░░░░░░░░░░░░║                                          ║░░░░░░░░║
║░░░░░░║                         ║░░░░░░░╚═════════╗ ╔═════╝░░░░░░░░░░░░░░░░░░║  ║░░░░░░░░░░░░░░░║           ╔═════════════════════╗        ║░░░░░░░░║
║░░░░░░║     ╔══════╗            ║░░░░░░░░░░░░░░░░░║ ║░░░░░░░░░░░░░░░░░╔══════╝  ╚══════╗░░░░░░░░║           ║░░░░░░░░░░░░░░░░░░░░░║        ║░░░░░░░░║
║░░░░░░║     ║░░░░░░║            ╚═════╗░░░░░░░░░░░║ ║░░░░░░░░░░░░░░░░░║                ║░░░░░░░░║   ╔═══════╝░░░░░░░░░░░░░░░░░░░░░║        ║░░░░░░░░║
║░░░░░░║     ║░░░░░░║                  ║░░░░░░░░░░░║ ║░░░░░░░░░╔═══════╝                ║░░░░░░░░║   ║░░░░░░░░░░░░░░░░░░░░░░░░░░░░░║        ║░░░░░░░░║
║░░░░░░║     ║░░░░░░║                  ║░░░░░░░╔═══╝ ║░░░░░░░░░║                        ║░░░░░░░░║   ║░░░░░░░░░░░░░░░░░░░░░░░░░░░░░╚════════╝░░░░░░░░║
║░░░░░░║     ║░░░░░░╚══════════════════╝░░░░░░░║     ║░░░░░░░░░║ ╔═══════╗              ╚════════╝   ╚═════════════════════════╗░░░░░░░░░░░░░░░░░░░░░║
║░░░░░░║     ║░░░░░░░░░░░░░░░░░░░░░░░░░░░░░░░░░║ ╔═══╝░░░░░░░░░║ ║░░░░░░░║                                                     ║░░░░░░░░░░░░░░░░░░░░░║
║░░░░░░║     ║░░░░░░░░░░░░░░░░░░░░░░░░░░░░░░░░░║ ║░░░░░░░░░░░░░║ ║░░░░░░░╚════╗         ╔═════════════╗  ╔════════════════╗    ║░░░░░░░░░░░░░░░░░░░░░║
║░░░░░░║     ╚═════════════╗░░░░░░░░░░░░░░░░░░░║ ╚═════════════╝ ║░░░░░░░░░░░░║         ║░░░░░░░░░░░░░║  ║░░░░░░░░░░░░░░░░║    ║░░░░░░░░░░░░░░░░░░░░░║
║░░░░░░║                   ╚═══════════════════╝                 ║░░░░░░░░░░░░║         ║░░░░░░░░░░░░░║  ║░░░░░░░░░░░░░░░░║    ║░░░░░░░░░░░░░░░░░░░░░║
║░░░░░░║                                         ╔═════════════╗ ║░░░░░░░░░░░░╚═════════╝░░░░░░░░░░░░░║  ║░░░░░░░░░░░░░░░░║    ╚═════════════╗░░░░░░░║
║░░░░░░║                   ╔═════════╗ ╔═════════╝░░░░░░░░░░░░░║ ╚══════╗░░░░░░░░░░░░░░░░░░░░░░░░░░░░░║  ╚═════════╗░░░░░░║                  ║░░░░░░░║
║░░░░░░║                   ║░░░░░░░░░║ ║░░░░░░░░░░░░░░░░░░░░░░░║        ║░░░░░░░░░░░░░░░░░░░░░░░░░░░░░║            ║░░░░░░╚════╗             ║░░░░░░░║
║░░░░░░╚════╗ ╔════════════╝░░░░░░░░░║ ║░░░░░░░░░░░░░░░░░░░░░░░║        ║░░░░░░░░░░░░░░░╔═════════════╝            ║░░░░░░░░░░░║             ║░░░░░░░║
║░░░░░░░░░░░║ ║░░░░░░░░░░░░░░░░░░░░░░║ ║░░░░░░░░░░░░░░░░░░░░░░░║        ║░░░░░░░░░░░░░░░║                          ║░░░░░░░░░░░║             ║░░░░░░░║
║░░░░░░░░░░░║ ║░░░░░░░░░░░░░░░░░░░░░░║ ║░░░░░░░░░░░░░░░░░░░╔═══╝        ╚════╗░░░░░░░░░░║                          ║░░░░░░░░░░░╚═════╗       ║░░░░░░░║
║░░░░░░░░░░░║ ╚═══════════╗░░░░░░╔═══╝ ╚════════╗░░░░░░░░░░║                 ║░░░░░░░░░░║                          ║░░░░░░░░░░░░░░░░░║       ║░░░░░░░║
║░░░░░░░░░░░║             ║░░░░░░║              ║░░░░░░░░░░║                 ║░░░░░░░░░░║                          ║░░░░░░░░░░░░░░░░░║       ║░░░░░░░║
║░░░░╔══════╝             ║░░░░░░║         ╔════╝░░░░░░░░░░║                 ║░░░░░░░░░░║                          ╚═════╗░░░░░░░░░░░║       ║░░░░░░░║
║░░░░║                    ║░░░░░░║         ║░░░░░░░░░░░░░░░║                 ║░░░░░░░░░░║                                ║░░░░░░░░░░░║       ║░░░░░░░║
║░░░░║                    ║░░░░░░║         ╚═══════╗░░░░░░░║                 ║░░░░░░░░░░║                                ║░░░░░░░░░░░╚═══════╝░░░░░░░║
║░░░░╚════════════════════╝░░░░░░║                 ║░░░░░░░╚═════════════════╝░░░░░░░░░░║                                ║░░░░░░░░░░░░░░░░░░░░░░░░░░░║
║░░░░░░░░░░░░░░░░░░░░░░░░░░░░░░░░╚═════════════════╝░░░░░░░░░░░░░░░░░░░░░░░░░░░░░░░░░░░░╚════════════════════════════════╝░░░░░░░░░░░░░░░░░░░░░░░░░░░║
╚════════════════════════════════════════════════════════════════════════════════════════════════════════════════════════════════════════════════════╝