╔══════════════════════════════════════════════════════════════════════════════════════════════╗
║░░░╔════════════════╗░░░░░░░░░░░░░░░░░░░░░░░░░░░░╔════════════╗░░░░░░░░░░░░░░░░░░░░░░░░░░░░░░░║
║░░╔╝                ╚╗░░░░░╔════════════╗░░░░░░░╔╝            ║░░░░░░░░░╔═══════════════╗░░░░░║
║░░║                  ║░░░░░║            ║░░░░░░╔╝             ║░░░░░░░░░║               ║░░░░░║
║░░║                  ║░░░░░║            ║░░░░░░║              ║░░░░░░░░░║               ║░░░░░║
║░░║                  ║░░░░░║           ╔╝░░░░░░║              ║░░░░░░░░░╚══════════╗    ║░░░░░║
║░░╚═════╗   ╔════════╝░░░░░║   ╔═══════╝░░░░░░░║  ╔═══════════╝░░░░░░░░░░░░░░░░░░░░║    ║░░░░░║
║░░░░░░░░║   ║░░░░░░░░░░░░░░║   ║░░░░░░░░░░░░░░░║  ║░░░░░░░░░░░░░░░░░░╔═══════╗░░░░░║    ║░░░░░║
║░░░░░░░░║   ║░░░░░░░░░░░░░░║   ║░░░░░░░░░░░░░░░║  ║░░░░░░░░░░░░░░░░░░║       ║░░░░░║    ║░░░░░║
║░░░░░░░░║   ║░░░░░░░░░░░░░░║   ║░░░░░░░░░░░░░░░║  ║░░░░░░░░░░░░░░░░░░║       ╚═════╝    ╚══╗░░║
║░░╔═════╝   ╚══════════════╝   ╚═══════════════╝  ║░░░░░░░░░░░░░░░░░░║                     ║░░║
║░░║                                               ║░░░░░░╔═══════════╝       ╔═══════════╗ ║░░║
║░░║                           ╔═══════╗    ╔══════╝░░░░░░║                   ║░░░░░░░░░░░║ ║░░║
║░░║                           ║░░░░░░░║    ║░░░░░░░░░░░░░║                   ║░░░░░░░░░░░║ ║░░║
║░░╚════════════╗              ║░░░░░░░║    ║░░░░░░░░░░░░░║                   ║░░░░░░░░░░░║ ║░░║
║░░░░░░░░░░░░░░░║              ║░░░░░░░║    ║░░░░░░░░░░░░░║            ╔══════╝░░░░░░╔════╝ ║░░║
║░░░░░░░╔═══════╝              ║░░░░░░░║    ║░░░░░░░░░░░░░╚═══════╗   ╔╝░░░░░░░░░░░░░║      ║░░║
║░░░░░░░║                      ║░░░░░░░║    ╚═══════╗░░░░░░░░░░░░░║  ╔╝░░░░░░░░░░░░░░║      ║░░║
║░░░░░░░║    ╔═══╗             ║░░░░░░░║            ║░░░░░░░░░░░░░║  ║░░░░░░░░░░░░░░░║      ║░░║
║░░░░░░░║    ║░░░╚═════════════╝░░░░░░░║            ║░░░░░░░░░░░░░║  ║░░░░░░░░░░░░░░░║      ║░░║
║░░░╔═══╝    ║░░░░░░░░░░░░░░░░░░░░░░░░░║            ║░░░░░░░░░░░░░║  ║░░░░░░░░░░░░░░░║    ╔═╝░░║
║░░░║        ╚══════╗░░░░░░░░░░░░╔═════╝            ║░░░░░░░░░░░░░║  ║░░░░░░░░░░░░░░░║    ║░░░░║
║░░░║               ║░░░░░░░░░╔══╝                  ╚═════════════╝  ╚═════════╗░░░░░╚════╝░░░░║
║░░░║               ║░░░░░░░░░║                                                ║░░░░░░░░░░░░░░░║
║░░░║               ║░░░░░░░░░║                     ╔═════════╗                ║░░░░░░░░░░░░░░░║
║░░░╚═════╗   ╔═════╝░░░░░░░░░║                     ║░░░░░░░░░║                ║░░░░░░░░░░░░░░░║
║░░░░░░░░░║   ║░░░░░░░░░░░░░░░║                     ║░░░░░░░░░║                ╚════╗░░░░░░░░░░║
║░░╔══════╝   ╚═════════╗░░░░░╚═════════════════════╝░░░░░░░░░║                     ║░░░░░░░░░░║
║░░║                    ║░░░░░░░░░░░░░░░░░░░░░░░░░░░░░░░░░░░░░║                     ║░░░░░░░░░░║
║░░║                    ║░░░░░░░░░░░░░░░░░░░░░░░░░░░░░░░░░░░░░╚═════════════════════╝░░░░░░░░░░║
║░░╚════════════════════╝░░░░░░░░░░░░░░░░░░░░░░░░░░░░░░░░░░░░░░░░░░░░░░░░░░░░░░░░░░░░░░░░░░░░░░║
╚══════════════════════════════════════════════════════════════════════════════════════════════╝