╔════════════════════════════════════════════════════════════════════════════════════════════════════════════════════╗
║░░░░░░░░░░╔═════╗░░░░╔═══════════╗░░░░░░░░░░░░░░░░░░░░░░░░░░░░░░░░░░░░░░░░░░░░░░░░░░░░░░░░░░░░░░░░░░░░░░░░░░░░░░░░░░║
║░░╔═══════╝     ║░░░░║           ║░░░░░░░░░░╔════════╗░░░░░░░╔══════════════════════════╗░░░░░░░╔══════════════╗░░░░║
║░░║             ╚════╝           ║░░░░░░░░░░║        ║░░░░░░░║                          ║░░░░░░░║              ║░░░░║
║░░║                              ╚═══╗░░░░░░║        ║░░░░░░░║                          ╚═══════╝              ║░░░░║
║░░║             ╔════╗               ║░░░░░░║        ╚═══════╝  ╔═════╗                                        ║░░░░║
║░░║             ║░░░░║               ╚══════╝                   ║░░░░░║                 ╔═══════════╗          ║░░░░║
║░░╚════╗  ╔═════╝░░░░║                                  ╔══╗  ╔═╝░░░░░║                 ║░░░░░░░░░░░║          ║░░░░║
║░░░░░░░║  ║░░░░░░░░░░║               ╔═══════╗          ║░░║  ║░░░░░░░║                 ║░░░░░░░░░░░║          ║░░░░║
║░░░░░░░║  ║░░░░░░░░░░║               ╚═══╗░░░╚╗         ║░░║  ║░░░░░░░║         ╔═══════╝░░░░░░░░░░░║          ║░░░░║
║░░░░░░░║  ║░░░░░░░░░░║                   ║░░░░╚══╗      ║░░║  ║░░░░░░░║         ║░░░░░░░░░░░╔═══════╝          ║░░░░║
║░░░░░░░║  ║░░░░░░░░░░║                   ║░░░░░░░║      ║░░║  ║░░░░░░░╚═════════╝░░░░░░░░░░░║                  ║░░░░║
║░░░░╔══╝  ║░░░░░░░░░░╚═══════════════════╝░░░░░░░╚══════╝░░║  ║░░░░░░░░░░░░░░░░░░░░░░░░░░░░░║                  ║░░░░║
║░░░░║     ╚══╗░░░░░░░░░░░░░░░░░░░░░░░░░░░░░░░░░░░░░░░░░░░░░║  ║░░░░░░░░░░░░░░░░░░░░░░░░░░░░░║                  ║░░░░║
║░░░░║        ╚═════╗░░░░░░░░░░░░░░░░░░╔═══════════╗░░░░░░░░║  ║░░░░░░░░░░░░░░░░░░░░░░░░░░░░░║                  ║░░░░║
║░░░░║              ║░░░░░░░░░░░░░░╔═══╝           ║░░░░░░░░║  ╚═════════════════════╗░░░░░░░║                  ║░░░░║
║░░░░║              ║░░░░░░░░░░░░░░║               ║░░░░░░░░║                        ║░░░░░░░║                ╔═╝░░░░║
║░░░░╚══╗  ╔════════╝░░░░░░░░░░░░░░║               ║░░░░░░░░║                        ╚═══════╝                ║░░░░░░║
║░░░░░░░║  ║░░░░░░░░░░░░░░░░░░░░░░░╚═════╗         ╚════════╝                                                 ║░░░░░░║
║░░░░░░░║  ║░░░░░░░░╔════╗░░░░░░░░░░░░░░░║                                           ╔═══════╗                ║░░░░░░║
║░░░░░░░║  ║░░░░░░░░║    ║░░░░░░░░░░░░░░░║                                           ║░░░░░░░╚════════════════╝░░░░░░║
║░░░░░░░║  ╚════════╝    ║░░░░░░░░░░░░░░░╚══════════════╗ ╔══════════════════════════╝░░░░░░░░░░░░░░░░░░░░░░░░░░░░░░░║
║░░░░░░░║                ║░░░░░░░░░░░░░░░░░░░░░░░░░░░░░░║ ║░░░░░░░░░░░░░░░░░░░░░░░░░░░░░░░░░░░░░░░░░░░░░░░░░░░░░░░░░░║
║░░░░░░░║                ╚══════╗░░░░░░░░░░░░░░░░░░░░░░░║ ║░░░░░░░░░░░░░░░░░╔═════════╗░░░░░░░░░░░░░░░░░░░░░░░░░░░░░░║
║░░░░░░░║                       ║░░░░░░░░░░░░░░░░░░░░░░░║ ║░░░░░░░░░░░░░░░░░╚╗        ║░░░░░░░╔════════╗░░░░░░░░░░░░░║
║░░░░░░░║                       ║░░░╔═════════╗░░░░░░░░░║ ╚════════╗░░░░░░░░░╚╗       ║░░░░░░░║        ║░░░░░░░░░░░░░║
║░░░░░░░╚═════════╗ ╔═══════════╝░░░║         ╚═════════╝          ║░░░░░░░░░░║       ╚═══════╝        ║░░░░░░░░░░░░░║
║░░░░░░░░░░░░░░░░░║ ║░░░░░░░░░░░░░░░║                              ║░░░░░░░░░░║                        ╚═════════╗░░░║
║░░░░░░░░░░░░░░░░░║ ╚═══════════════╝         ╔═══════╗            ╚══════════╝       ╔═══════╗                  ║░░░║
║░░░░░╔═══════════╝                        ╔══╝░░░░░░░║                               ║░░░░░░░║                  ║░░░║
║░░░░░║                                    ║░░░░░░░░░░║                        ╔══════╝░░░░░░░║                  ╚═╗░║
║░░░░░║                                    ║░░░░░░░░░░╚════════════════════════╝░░░░░░░░░░░░░░╚════════════════════╝░║
║░░░░░╚════════════════════════════════════╝░░░░░░░░░░░░░░░░░░░░░░░░░░░░░░░░░░░░░░░░░░░░░░░░░░░░░░░░░░░░░░░░░░░░░░░░░║
╚════════════════════════════════════════════════════════════════════════════════════════════════════════════════════╝