╔═══════════════════════════════════════════════════════════════════════════════════════════════════════╗
║░░░░░░░░░░░░░░░░░░░░░░░░░░░░░░░░░░░░░░░╔════════════════════════════╗░░░░░░░░░░░░░░░░░░░░░░░░░░░░░░░░░░║
║░░╔══════════════╗░░░░░░░╔═══╗░░░░░░░░░║                            ║░░░░░░╔═══════════╗░░░░░╔═════╗░░░║
║░░║              ║░░░░░░░║   ║░░░░░░░░░║                   ╔══╗ ╔═══╝░░░░░░║           ║░░░░░║     ║░░░║
║░░║              ║░░░░░░░║   ╚═════════╝                   ║░░║ ║░░░░░░░░░░║           ║░░░░░║     ║░░░║
║░░║              ║░░░░░░░║                    ╔════════════╝░░║ ╚══════════╝           ╚═════╝     ║░░░║
║░░║              ╚═══════╝   ╔══════════════╗ ║░░░░░░░░░░░░░░░║                                    ║░░░║
║░░║                          ║░░░░░░░░░░░░░░║ ║░░░░░░░░░░░░░░░╚═══════╗                            ║░░░║
║░░║                          ║░░░░░░░░░░░░░░║ ║░░░░░░░░░░░░░░░░░░░░░░░║                            ║░░░║
║░░╚═════════════════╗        ║░░░░░░░░░░░░░░║ ║░░░░░░░░░░░░░░░░░░░░░░░╚══════════════════╗         ║░░░║
║░░░░░░░░░░░░░░░░░░░░║        ║░░░░░░░░░░╔═══╝ ╚════╦══════════╦════════════╦══════════╗░░║         ║░░░║
║░░░░░░░░░░░░░░░░░░░░║        ║░░░░░░░░░░║          ║          ║            ║          ║░░║         ║░░░║
║░░░░░╔════════╗░░░░░╚══╗ ╔═══╝░░░░░░░░░░║          ║                       ║          ╚══╝         ║░░░║
║░░░░░║        ║░░░░░░░░║ ║░░░░░░░░░░░░░░║                                                          ║░░░║
║░░░░░║        ║░░░░░░░░║ ║░░░░░░░░░░░░░░║          ║          ║            ║          ╔═══╗        ║░░░║
║░░░░░║        ║░░░░░░░░║ ║░░░░░░░░░░░░░░║          ║          ║            ║          ║░░░║        ║░░░║
║░░░░░║        ║░░░░░░░░║ ║░░░░░░░░░░░░░░╠════  ════╬════  ════╬════  ══════╬══════  ══╣░░░║        ║░░░║
║░░╔══╝        ╚════════╝ ║░░░░░░░░░░░░░░║          ║          ║            ║          ║░░░║        ║░░░║
║░░║                      ║░░░░░░░░░░░░░░║          ║          ║            ║          ║░░░║     ╔══╝░░░║
║░░║                      ╚══════════════╝                                             ║░░░║     ║░░░░░░║
║░░║                                                ║                                  ║░░░║     ║░░░░░░║
║░░║                            ╔════════╗          ║          ║            ║          ║░░░║     ║░░░░░░║
║░░╚═════════╗ ╔════════════════╝░░░░░░░░╚══════════╩══════════╩═════╗ ╔════╩══════════╝░░░║     ║░░░░░░║
║░░░░░░░░░░░░║ ║░░░░░░░░░░░░░░░░░░░░░░░░░░░░░░░░░░░░░░░░░░░░░░░░░░░░░║ ║░░░░░░░░░░░░░░░░░░░║    ╔╝░░░░░░║
║░░░░░░░░░░░░║ ║░░░░░░░░░░░░░░░░░░░░░░░░░░░░░░░░░░░╔═════════════════╝ ╚════╗░░░░░░░░░░░░░░║    ║░░░░░░░║
║░░░░░░░░░░░░║ ╚════════════════╗░░╔═══════════════╝                        ║░░░░░░░░░░░░░╔╝    ║░░░░░░░║
║░░░░╔═══════╝                  ║░░║                                        ║░░░░░░░░░░░░╔╝     ║░░░░░░░║
║░░░░║                          ║░░║                                        ╚════════════╝      ╚═══╗░░░║
║░░░░║                          ║░░║ ╔══════╗                                                       ║░░░║
║░░░░║                          ║░░║ ║░░░░░░║          ╔══════╗             ╔═══════════╗           ║░░░║
║░░░░╚═════╗                    ║░░║ ║░░░░░░║          ║░░░░░░║             ║░░░░░░░░░░░║           ║░░░║
║░░░░░░░░░░║                    ╚══╝ ║░░░░░░║          ║░░░░░░╚═════════════╝░░░░░░░░░░░║           ║░░░║
║░░░░░░░░░░║                         ║░░░░░░╚══════════╝░░░░░░░░░░░░░░░░░░░░░░░░░░░░░░░░╚═══════════╝░░░║
║░░░░░░░░░░╚═════════════════════════╝░░░░░░░░░░░░░░░░░░░░░░░░░░░░░░░░░░░░░░░░░░░░░░░░░░░░░░░░░░░░░░░░░░║
╚═══════════════════════════════════════════════════════════════════════════════════════════════════════╝