╔════════════════════════════════════════════════════════════╗
║                                                            ║
║     ╔══╗                                                   ║
║     ║░░║                                                   ║
║     ║░░║                                                   ║
║     ║░░║                 ╔═════╗                           ║
║     ║░░║                 ║░░░░░║                           ║
║     ║░░║                 ╚═════╝                           ║
║     ╚══╝                                                   ║
║                                         ╔══╗               ║
║                                         ║░░╚═════╗         ║
║                                         ║░░░░░░░░║         ║
║                                         ╚════════╝         ║
║          ╔══╗                                              ║
║          ║░░║                     ╔═══╗                    ║
║          ╚══╝                     ║░░░║                    ║
║                                   ║░░░║                    ║
║                                   ║░░░║                    ║
║         ╔═══╗                     ║░░░║                    ║
║         ║░░░║                     ╚═══╝                    ║
║         ║░░░║                                              ║
║       ╔═╝░░░╚═════╗                                        ║
║       ║░░░░░░░░░░░║                      ╔════════╗        ║
║       ║░░░░░░░░╔══╝                      ║░░░░░░░░║        ║
║       ╚════════╝                         ╚════════╝        ║
║                                                            ║
╚════════════════════════════════════════════════════════════╝